NO ./textures/eagle.xpm
SO ./textures/greystone.xpm
WE ./textures/purplestone.xpm
EA ./textures/red.xpm

F 125,125,125
C 0,200,255

                 1111111111111
                 1000000000001
                 1111111111101
111111111111111111000000000001
1S1000001000000011010111111111
101000001100000110010000001
101000001000000011111111101
101000001100000111111000001
101000001000000011111011111
101110111100000111111011111
100000000000000000000000001
100000000000000000000000001
100000000000000000000000001
111101111111110111111111111
100000001000000000001
100000001000000000001
110101011000000000001
111111111111111111111