R 720 480

NO ./textures/north_texture.xpm
SO ./textures/south_texture.xpm
WE ./textures/west_texture.xpm
EA ./textures/east_texture.xpm

S ./textures/sprite.xpm

F 125,125,125
C 0,200,255

11111
11011
10N01
11011
11111