R 640 480

NO ./images/cava
SO ./images/passer
WE ./images/tinquiete
EA ./images/pasfrer

S ./images/undernierpourlaroute

C 100,100,100
F 200,200,200

11111
10001
10N01
10001
11111
